%%%%%%%
%     %
% % % %
% % % %
%%%%%%%